.,.,.,.,.,.,.,.,.,.
.,#,.,.,.,.,.,#,.,.
.,.,.,.,.,.,.,.,.,.
.,.,.,.,i,.,.,.,.,.
.,#,d,d,d,d,d,#,.,.
.,.,#,#,#,#,#,.,.,.
.,.,.,.,.,.,.,.,.,.
.,.,.,.,.,.,.,.,.,.
.,.,.,.,.,.,.,.,.,.
.,.,.,.,.,.,.,.,.,.

