#,#,#,#,#,#,#,#,#,#,#,#,#,#,#,#,#,#,#,#
#,.,.,.,.,.,.,.,.,l,#,l,l,l,l,l,l,l,l,#
#,#,#,#,#,#,#,.,.,l,#,l,l,l,l,.,.,.,l,#
#,#,#,#,#,.,.,.,.,l,#,l,l,l,l,.,d,.,l,#
#,#,.,.,.,.,.,.,.,#,#,#,l,l,l,.,.,.,l,#
#,.,.,.,.,.,.,.,.,#,#,#,l,l,l,.,.,.,l,#
#,.,.,#,.,.,.,.,.,#,#,#,l,l,l,.,.,.,l,#
#,#,#,#,.,.,.,.,.,#,#,#,#,#,#,e,e,#,#,#
#,.,.,.,#,.,.,.,.,#,#,.,.,.,.,.,.,.,l,#
#,.,b,.,.,.,.,.,.,.,#,.,.,.,.,.,.,l,l,#
#,.,.,.,#,#,.,.,.,.,.,.,.,.,.,.,l,l,l,#
#,.,b,.,#,#,.,.,.,.,.,.,.,.,.,l,l,l,l,#
#,#,#,#,#,#,.,.,.,.,#,.,.,l,l,l,l,l,l,#
#,l,l,l,l,#,.,.,#,e,#,.,.,l,l,l,l,l,l,#
#,l,e,e,e,.,.,.,#,.,.,.,.,l,l,l,l,l,l,#
#,l,e,e,e,.,.,.,#,.,.,.,l,l,l,l,l,l,l,#
#,l,e,#,#,#,#,.,.,.,.,l,l,l,l,l,l,l,l,#
#,l,i,#,l,l,#,.,.,.,l,l,l,l,l,l,l,l,l,#
#,l,l,l,l,l,#,.,.,l,l,l,l,l,l,l,l,l,l,#
#,#,#,#,#,#,#,#,#,#,#,#,#,#,#,#,#,#,#,#

