#,#,#,#,#,#,#,#,#,#,#,#,#,#,#,#,#,#,#,#
#,l,#,.,.,.,.,#,.,.,e,.,.,e,#,#,#,#,#,#
#,l,#,.,.,i,d,#,e,#,#,#,#,.,#,#,#,#,#,#
#,l,#,.,.,.,.,#,.,#,l,l,#,.,#,.,l,.,#,#
#,l,#,e,e,#,#,#,.,#,l,l,#,.,#,.,.,.,#,#
#,l,#,.,.,#,l,#,e,#,l,l,#,e,#,.,.,.,#,#
#,l,#,.,.,#,l,#,.,#,l,l,#,.,#,.,b,.,#,#
#,l,#,.,.,#,l,#,.,#,l,l,#,.,#,.,.,.,.,#
#,l,#,.,.,#,l,#,.,#,l,l,#,.,#,#,#,#,.,#
#,l,#,.,.,#,l,#,.,#,l,l,#,e,.,#,l,#,e,#
#,l,#,.,.,#,l,#,.,#,l,l,#,#,.,#,l,#,.,#
#,l,#,.,.,#,l,#,e,#,l,l,l,#,e,#,l,#,.,#
#,l,#,.,.,#,l,#,.,#,l,l,l,#,.,#,l,#,.,#
#,l,#,.,.,#,l,#,.,#,l,l,l,#,.,#,l,#,e,#
#,l,#,.,.,#,l,#,.,#,l,i,l,#,e,#,l,#,.,#
#,l,#,.,.,#,l,#,.,#,l,l,l,#,.,#,l,#,.,#
#,l,#,e,e,#,#,#,e,#,l,l,l,#,.,#,#,#,.,#
#,l,#,.,.,.,.,.,.,#,l,l,l,#,e,.,.,.,e,#
#,#,#,#,#,#,#,#,#,#,#,#,#,#,#,#,#,#,#,#


