.,.,.,.,.,.,.,.,.,.
.,#,.,.,.,.,.,#,.,.
.,.,.,.,.,.,.,.,.,.
.,.,.,.,.,.,.,.,.,.
.,#,.,.,.,.,.,#,.,.
.,.,#,#,#,#,#,.,.,.
.,.,.,.,.,.,.,.,.,.
.,.,.,.,p,p,.,.,.,.
.,.,.,.,.,.,.,.,.,.
.,.,.,.,.,.,.,.,.,.
